111111111111111111111111111111111111111111111
1E0C00000C01111111111111111111111111111111111
1P0000000011111111111111111111111111111111111
111111111111111111111111111111111111111111111