11111111111
1C0E00000C1
11110000001
10000000P01
11111111111