11111111111
1c100000001
10100000001
11000000001
11111111111