11111111111
1C0001000C1
11111000001
1000E000P11
11111111111