11111111111
1C100000001
10100000001
11000000001
11111111111